|-|    |-|
| |    |*|
| |    | |
| |____| |
|        |
----------